1111111111111111
1CCC000000000001
1111111000010011
100000110001C211
100010C10001C001
100011110P011111
100000000100C001
100000E001000011
1111111111111111