1111111111111111111111111111
10CC0000000000000CC001001CC1
101100S00C01C0100CC0110C1CC1
1CC111110C01C2101CC010CC0CC1
1CC000C10C01C00C1000100C0001
1CC0111100011001111111103101
10000C000Pp0C000C10000100001
100001110CC000000C01001C1111
1CCC00410CC111111101111C1CC1
11ww1C00010CC0CC010C01CC11C1
1CCC00E10000CC110000C1CCCCs1
1111111111111111111111111111